0000000000000000
0111110000000200
0111110000000200
0111110000000200
0000000000000200
0000000000000200
0000000000000000
0000000000000000
0000000000000000