0000000000000000
0222220000000100
0222220000000100
0222220000000100
0000000000000100
0000000000000100
0000000000000000
0000000000000000
0000000000000000