Unit, X, Y, Team
0, 1, 1, 0
1, 1, 2, 0
1, 1, 3, 0
0, 5, 1, 1
1, 5, 2, 1
1, 5, 3, 1
